#表記	読み	クラス
#---世界---
ルミア島	るみあとう	地名
#---試合中(バトルロイヤル)---
港	みなと	地名
倉庫	そうこ	地名
池	いけ	地名
川	かわ	地名
浜辺	はまべ	地名
高級住宅街	こうきゅうじゅうたくがい	地名
路地裏	ろじうら	地名
ガソリンスタンド	がそりんすたんど	地名
ホテル	ほてる	地名
警察署	けいさつしょ	地名
消防署	しょうぼうしょ	地名
病院	びょういん	地名
寺	てら	地名
洋弓場	ようきゅうじょう	地名
墓場	はかば	地名
森	もり	地名
工場	こうじょう	地名
教会	きょうかい	地名
学校	がっこう	地名
研究所	けんきゅうじょ	地名
脱出地域	だっしゅつちいき	地名
#---試合中(コバルト)---
セーフゾーン	せーふぞーん	地名
ガンマ地域	がんまちいき	地名
状況室	じょうきょうしつ	地名
#---試合外---
作戦会議室	さくせんかいぎしつ	地名
