ロウブロウ	ろうぶろう	固有名詞
リプライザル	りぷらいざる	固有名詞
挑発	ちょうはつ	固有名詞
ランパート	らんぱーと	固有名詞
インタージェクト	いんたーじぇくと	固有名詞
アームズレングス	あーむずれんぐす	固有名詞
シャーク	しゃーく	固有名詞
レッグスウィープ	れっぐすうぃーぷ	固有名詞
牽制	けんせい	固有名詞
トゥルーノース	とぅるーのーす	固有名詞
レッグスウィープ	れっぐすいーぷ	固有名詞
ブラッドバス	ぶらっどばす	固有名詞
内丹	ないたん	固有名詞
プロトン	ぷろとん	固有名詞
ヘッドグレイズ	へっどぐれいず	固有名詞
ルーシッドドリーム	るーしっどどりーむ	固有名詞
エスナ	えすな	固有名詞
迅速魔	じんそくま	固有名詞
堅実魔	けんじつま	固有名詞
救出	きゅうしゅつ	固有名詞
アドル	あどる	固有名詞
