イフリート	いふりーと	名前
タイタン	たいたん	名前
ガルーダ	がるーだ	名前
リヴァイアサン	りばいあさん	名前
モグル・モグ	もぐるもぐ	名前
ラムウ	らむう	名前
シヴァ	しば	名前
オーディン	おーでぃん	名前
ラーヴァナ	らーばな	名前
ビスマルク	びすまるく	名前
トールダン	とーるだん	名前
ナイツ・オブ・ラウンド	ないつおぶらうんど	固有名詞
蒼天幻想	そうてんげんそう	固有名詞
セフィロト	せふぃろと	名前
ソフィア	そふぃあ	名前
ズルワーン	ずるわーん	名前
バハムート	ばはむーと	名前
機工城	きこうじょう	固有名詞
アレキサンダー	あれきさんだー	固有名詞
スサノオ	すさのお	名前
ラクシュミ	らくしゅみ	名前
イノセンス	いのせんす	名前
ティターニア	てぃたーにあ	名前
ハーデス	はーです	名前
ツクヨミ	つくよみ	名前
エンキドゥ	えんきどぅ	名前
ギルガメッシュ	ぎるがめっしゅ	名前
終焉を謳うもの	しゅうえんをうたうもの	名前
ウォーリアー・オブ・ライト	うぉーりあーおぶらいと	名前
