ロドス	ろどす	地名
ロドス・アイランド	ろどすあいらんど	会社名
ウルサス	うるさす	地名
龍門	ろんめん	地名
レユニオン	れゆにおん	会社名
チェルノボーグ	ちぇるのぼーぐ	地名
炎国	やん	地名
ヴィクトリア	びくとりあ	地名
レム・ビリトン	れむびりとん	地名
クルビア	くるびあ	地名
カジミエーシュ	かじみえーしゅ	地名
騎士競技	きしきょうぎ	固有名詞
商業連合会	しょうぎょうれんごうかい	会社名
カズデル	かずでる	地名
ラテラーノ	らてらーの	地名
シラクーザ	しらくーざ	地名
リターニア	りたーにあ	地名
イベリア	いべりあ	地名
イェラグ	いぇらぐ	地名
シエスタ	しえすた	地名
ミノス	みのす	地名
ヴィーヴル	びーぶる	地名
サルゴン	さるごん	地名
ボリバル	ぼりばる	地名
エーギル	えーぎる	地名
ガリア	がりあ	地名
源石	おりじにうむ	固有名詞
鉱石病	おりぱしー	固有名詞
龍門幣	ろんめんへい	固有名詞
PRTS	ぴーあーるてぃーえす	固有名詞
