アスラン	あすらん	役職名
アダクリス	あだくりす	役職名
アナサ	あなさ	役職名
アナティ	あなてぃ	役職名
アヌーラ	あぬーら	役職名
イトラ	いとら	役職名
ウルサス	うるさす	役職名
ヴァルポ	ばるぽ	役職名
ヴイーヴル	ぶいーぶる	役職名
エーギル	えーぎる	役職名
エラフィア	えらふぃあ	役職名
オニ	おに	役職名
キャプリニー	きゃぷりにー	役職名
麒麟	きりん	役職名
クランタ	くらんた	役職名
コータス	こーたす	役職名
サルカズ	さるかず	役職名
サンクタ	さんくた	役職名
サヴラ	さぶら	役職名
ザラック	ざらっく	役職名
セラト	せらと	役職名
ドゥリン	どぅりん	役職名
ドラコ	どらこ	役職名
ピロサ	ぴろさ	役職名
フィディア	ふぃでぃあ	役職名
フェリーン	ふぇりーん	役職名
フォルテ	ふぉるて	役職名
ペッロー	ぺっろー	役職名
ペートラム	ぺーとらむ	役職名
リーベリ	りーべり	役職名
ループス	るーぷす	役職名
レプロバ	れぷろば	役職名

